____________
|          |
|          |
|          |
|          |
------------